1111111111111111111111111111111111
1000000000000000000000000E10000001
1000000000000000000000000000010101
101001001010101000100100000001C101
1P00000000000000000000000000000001
1111111111111111111111111111111111