1111111111111111111111111111111111
1000000000000000000000011E10000001
1010010100100000101001000100010101
101001001010101000100100000001C101
1P00000000000000000000000000000001
1111111111111111111111111111111111