1111111111111111111111111111111111111111
1C0C000001111111111111111111111111111111
1010000001111111111111111111111111111111
1E00P00001111111111111111111111111111111
1000000001111111111111111111111111111111
10000000C1111111111111111111111111111111
1111111111111111111111111111111111111111
1111111111111111111111111111111111111111
1111111111111111111111111111111111111111
1111111111111111111111111111111111111111
1111111111111111111111111111111111111111
1111111111111111111111111111111111111111
1111111111111111111111111111111111111111
1111111111111111111111111111111111111111
1111111111111111111111111111111111111111
1111111111111111111111111111111111111111