11111111111111111111111111
10000000000000000000000001
10000000000000000000000001
10000000000000000000000001
10000000000000000000000001
10000000000000000000000001
10000000000000000000000001
10000P00000000000000000001
10000000000000000000C00001
10000000000000000000000001
10000000000000000000000001
10000000000000000E00000001
10000000000000000000000001
11111111111111111111111111