111111
1C0C01
101001
1E00P1
111111