11111111111111111111111111
1P00000000000C0000000000E1
10000000000000000000000001
10000000000000000000000001
10000000000000000000000001
1000000C0000C0000000000001
1000000000000000000C000001
11111111111111111111111111