11111111111111111111111111
15555555555555555555555551
15000000000000000000000051
15000000000000000000000051
15000000000000000000000051
15000000000000000000000051
15000000000000000000000051
15000P00000000000000000051
15000000000000000000C00051
15000000000000000000000051
15000000000000000000000051
15000000000000000E00000051
15555555555555555555555551
11111111111111111111111111