1111111111
1C0C000001
1010000001
1E00P00001
1000000001
10000000C1
1111111111