1111111111111111111
1C0C000000000000001
1010000000000000001
1000000100001P00001
1000000100000000001
10000001000000000E1
1111111111111111111