1111111111111111111
1C0C0000000000000P1
1010000000000000001
10001C1C1C1C1C10001
1000000000000000001
10000000000000000E1
1111111111111111111